{
    "1": "60",
    "2": "50",
    "3": "40",
    "4": "40",
    "5": "40",
    "6": "40"
}